XXXXXXXXXXXXXX
XPXXXXXXXXXXXX
X   XX       X
X X X  XXXXX X
X X XX     XXX
X X    XXX X F
X XXXX X X X X
X    X X   X X
XXXXXX XXXXX X
X            X
XXXXXXXXXXXXXX
